╔════════╗
║░0000000║
╠═══╦══╗0║
║00♦║█0║0║
║000000║0║
║0╔════╝0║
║0║♦00000║
║♦╠═════0║
║0║♦00000║
║0╚═══╗00║
║00000║00║
║0║♦║♦║00║
║0╚═╬═╝00║
║000║0000║
║0000000♦║
╚════════╝