ABBBBBBBBD
CL-$-----C
HBBBIBBD-C
C--$CS-C-C
C------C-C
C-ABBBBE-C
C-C$-----C
C$HBBBBB-C
C-C$-----C
C-FBBBD--C
C-----C--C
C-C$C$C--C
C-FBGBE--C
C---C----C
C-------$C
FBBBBBBBBE