ABBBBBBBBBBBBBD
C-------------C
CBBBD-ABB-BBD-C
C--$CLC-----C-C
C---FBE-----C-C
C----------$C-C
HB-BIBBIBBBBE-C
C---C---------C
C---C-C-C-----C
C---C-C-C$--ABC
C---C-C-FBBBE$C
C---C-C-------C
C$-$C-FBBBBBDSC
C---C-------FBC
C-$-C-------$-C
FBBBJBBBBBBBBBE